Wn-Wj-Wj-Wj-WjID-Wj-Wj-Wj-Wj-Wk:
Wh- D- U- U- U- U- U- U- U-Wg:
Wh- U- U- U- U- U- U- U- L-Wg:
Wh- U-WL-WR- U- U-WL-WR- U-Wg:
Wh- U- U- U- R- U-PU- U- U-Wg:
Wh-OR- U- L- U-ML- U- U- U-Wg:
Wh- U-Wz- U- U- U- U-Wz- L-Wg:
Wh- U- U-WL-Wf-Wf-WR- U- U-Wg:
Wh- R- U- U- U- U- U- U- U-Wg:
Wl-Wi-Wi-Wi-Wi-Wi-Wi-Wi-Wi-Wm